R 1980 1040

NO ./textures/WALL_NORD.xpm
SO ./textures/WALL_SOUTH.xpm
WE ./textures/WALL_WEST.xpm
EA ./textures/WALL_EAST.xpm
S ./textures/SPRITE.xpm

F 133,99,99
C 55,92,44

11111111111111111
10022222222222001
10000000000000001
10000000000000001
10000000000000001
10020000000000001
10000000000000001
10000000000000001
10000000000000001
10000000N00000001
10000000000000001
11111111111111111