
R 1980 1040  

F 13,99,9
C 150,151,3

NO ./textures/WALL_NORD.xpm
SO ./textures/WALL_SOUTH.xpm
WE ./textures/WALL_WEST.xpm
EA ./textures/WALL_EAST.xpm
S ./textures/SPRITE.xpm

111111111111111111
100000000000000001
100000000000000001
100000000000000001
100000000000000001
100000000000000001
100000000000000001
100000000000000001
100000000000000001
110022222222222001
11000000000000N001
111111111111111111