R 1080 720

NO

11111111111111111
10022222222222001
10000000000000001
10000000000000001
100000000000000001
10000200000000001
10000000000000001
10000000000000001
10000000000000001
10000000N00000001
10000000000000001
11111111111111111