R 1080 720

NO

11111111111111111
10000222222200001
10020000000000001
10000000000000001
10000000002000001
10000200000000001
10000000000000001
10000000000000001
10000000000000001
10000000N00000001
10022222222222001
11111111111111111